*....*.....*
............
*...........
............
............
.....***....
.....*.*....
.....***....
*..........*
