.........
...*..**.
.........
.........
...*...*.
........*
........*
.........
*......**